Tribe Society - Kings
Meek Mill - Pullin Up feat. The Weekend
X Ambassadors - Gorgeous
Nicky Romero - Lighthouse
FLETCHER - War Paint
The Game - 100 feat. Drake
Kaptan - Anywhere We Go
Miguel - leaves
Vince Staples - Dopeman feat. Joey Fatts & Kilo Kish
Years & Years - Eyes Shut
Bassnectar - Speakerbox feat. Lafa Taylor
OIJ - Blinded
The Front Bottoms - Cough It Out
Dear Rouge - Tongues
Fetty Wap - 679 feat. Remy Boyz
Chris Brown - Liquor
XY&O - Low Tide
Joy Williams - Before I Sleep
Colony House - Waiting for My Time to Come
Kotomi - Swimming
Miguel - Simple Things
The Fratellis - Baby Don't You Lie to Me!
W. Darling - Learn to Love
Gallant - Weight in Gold
Robin Thicke - Morning Sun
Jon Foreman - Your Love is Enough
Son Lux - Change Is Everything
Bilal - Money Over Love feat. Kendrick Lamar
Wale - The Girls On Drugs (Live)
Anne-Marie - Karate
Jimi Charles Moody - Other Man
California Wives - The Heart Always Breaks
The Mowgli's - Summertime
Hunter Hunted - Lucky Day
Prince Royce - Extraordinary
Good Old War - Never Gonna See Me Cry
Kris Kross Amsterdam - Until the Morning feat. CHOCO
The bird and the bee - Los Angeles
Matt Pond PA - The State of Gold, Pt. 2
Chet Faker - Bend
LA Priest - Lady's in Trouble With the Law
Elephante - I Want You feat. Rumors
Krystalmath - Same Mistake
Jack Grace - Hills
Klyne - Paralyzed
Astronauts, Etc. - Eye to Eye
Lolawolf - Every Fuckin' Day
Petite Noir - Down
Lil Wayne - Nothing But Trouble feat. Charlie Puth
ZZ Ward - Lonely