Childish Gambino - California
San Holo - Light
Train - Working Girl
MUNA - I Know a Place
Nicki Minaj & Mike Will Made It - Black Barbies
John Legend - What Do You Do to Me
Tritonal & SJ - Hung Up feat. & Emma Gatsby
Molly Kate Kestner - Good Die Young
Deadmau5 - Imaginary Friends
Post Malone - Leave
Kehlani - Advice
Sigala - Only One
Bridgit Mendler - Do You Miss Me At All (Marian Hill Remix)
The Rolling Stones - Hate to See You Go
Tove Lo - cool girl (Recorded at Spotify Studios NYC)
Elkka - Try
Grace VanderWaal - Light the Sky
Total Ape - Young Gods
DJ Snake - Let Me Love You feat. Justin Bieber (Marshmello Remix)
Colouring - Symmetry
Wiz Khalifa - Washingtons by Your Side
Hey Violet - Guys My Age (Stripped)
XYLØ - Get Closer
Adam Friedman - Sad
Kyle - iSpy feat. Lil Yachty
Vaults - Hurricane
Sia - Angel by the Wings
R3hab - Icarus (Black Caviar Remix)
Imagine Dragons - Levitate
Colony House - This Beautiful Life
Frank Carter & The Rattlesnakes - Wild Flowers
Coast Modern - Cute
AFI - Aurelia
My Chemical Romance - Welcome to the Black Parade (Steve Aoki 10th Anniversary Remix)
Khalid - Reasons
RKCB - Disorder
Run the Jewels - Legend Has It
Mozart Rick - Window
John Legend - What's Going On
Jessie J - Can't Take My Eyes Off You x MAKE UP FOR EVER
Pierce Fulton - Just You feat. Puppet
Fenech-Soler - Cold Light
MishCatt - Another Dimension (Skolhaus Version)
Kane Brown - Better Place
Empire Cast - Aces High
Matt Woods - Styrofoam
GRiZ - What We've Become
Jarle Skavhellen - The Ghost In Your Smile
Matt Citron - Save My Soul
Salaam Remi - Come Through and Chill feat. Miguel
Jeremy Thurber - Find You in the Dark
Lower Than Atlantis - Had Enough
Rafferty - Save Me Some Sunshine
BISHØP - F.F.Y. (Feeling for You)
Milo Greene - We Kept the Lights On
DVBBS - Wicked Ways feat. Stella Rio
Paerish - I Got Punched in the Face, What's Your ExcuseEmbed