2 ContributorsNew Music Friday 11/27/15 LyricsMajor Lazer - Boom feat. MOTi, Ty Dolla $ign, Wizkid & Kranium
Al Bairre - Let's Fall In Love Some More
Coldplay - Everglow feat. Gwyneth Paltrow
Erik Hassle - Smaller
HONNE - Gone are the Days
Yellow Claw - In My Room feat. DJ Mustard, Ty Dolla $ign & Tyga
Sia - One Million Bullets
Chris Brown - Fine By Me
TOKiMONSTA - Put It Down feat. Anderson Paak & KRNE
Panic! At The Disco - LA Devotee
Who Is Fancy - Boys Like You feat. Meghan Trainor & Ariana Grande
Foxes - If You Leave Me Now
Lucas Nord - Faking
Lenno - Fever feat. Benson
KYKO - Pull Me Up
Blackbear - Help feat. Maejor Ali
Solo Woods - Lightwalk
Shovels & Rope - Bullet Belt feat. Butch Walker
Foreign Air - Free Animal
Foo Fighters - Saint Cecilia
Ten Fe - In the Air
Glass Face - Hotline Bling
Azekel - The War Inside
Rich Homie Quan - The Most feat. Young Thug
The Vamps - Volcano feat. Silento
Kita Alexander - Plain Sight feat. Wondershow
DiRTY RADIO - Numbers
Mack Wilds - Love in the 90z
Disclosure - Magnets feat. Lorde (A-Track Remix)
Parson James - Temple (Lenno Remix)
Sigma - Coming Home feat. Rita Ora
David Guetta - Bang My Head feat. Sia & Fetty Wap
Mr Little Jeans - Fool 4 You
Jude Woodhead - Beautiful Rain
Lastlings - Chills
G-Eazy - Sad Boy
Rick Ross - Crocodile Python
Santigold - Who Be Lovin Me feat. ILOVEMAKONNEN
Wild Nothing - To Know You
Club Kuru - Flat Out Lie
French For Rabbits - Feathers & Dreams
Aaron Espe - Making All Things New
Third Eye Blind - Rites of Passage
Wild & Free - River of Nile
Slumberjack - Enigma feat. GRRL PAL
Madeline Juno - Into the Night
EDEN - Billie Jean
Wafia - Heartburn
Paerish - Then People Forget
Hidden Charms - Love You Cause You're There1Embed