3 ContributorsNew Music Friday 02/26/16 LyricsFlo Rida - Hello Friday feat. Jason Derulo
Birdy - Keeping Your Head Up
Josef Salvat - Paradise
Charli XCX - Vroom Vroom
Tritonal - This Is Love
Pvris - You and I
Tinashe - Ride of Your Life
Zhu - In the Morning
Madeintyo - Uber Everywhere
ZAYN - iT's YoU
Hailee Steinfeld - Rock Bottom feat. DNCE
Miguel - waves (Remix) feat. Travis Scott
Macklemore & Ryan Lewis - Dance Off feat. Idris Elba & Anderson .Paak
Shura - Touch
Bibi Bourelly - Sally
Icona Pop - Someone Who Can Dance
Akon - Good Girls Lie
The Knocks - Love Me Like That feat. Carly Rae Jepsen
Devon Baldwin - Ring of Fire
The Rocket Summer - Help Me Out
Stephen - Sincerely
Gnash - i hate u, i love u feat. Olivia O'Brien
The Struts - Only Just a Call Away
The Starting Line - Luck
Wildes - Bare
Operators - Cold Light
Blackbear - Paragraphs
MOTHXR - Easy
James TW - When You Love Someone
XYLÃ˜ - BLK CLD
SKYES - Quarks
Jon Bellion - All Time Low (Acoustic)
Bishat - Sober
Nicky Romero - Future Funk
Mayer Hawthorne - Love Like That
Zedd - Candyman feat. Aloe Blacc
Run River North - Pretender
Weezer - King of the World
School of Seven Bells - Ablaze
Mothers - It Hurts Until it Doesn't
Kate Boy - A Girl Like You
Tokimonsta - Giving Up feat. Jonny Pierce
Santigold - Walking in a Circle
Parson James - Temple (Niko the Kid Remix)
Jillian Jacqueline - Prime
Lovespeake - Tightrope
K. Michelle - Time
Gold Panda - Time Eater
Texada - All My Life1Embed