Rachel Platten - Astronauts
Selena Gomez - Same Old Love (Grey Remix)
Tom Bull - Bound To You ft. Nadia Gattas
Ra Ra Riot - Absolutely
High Tyde - Do What You Want
Panic! At The Disco - Don't Threaten Me With A Good Time
Russ - The Formula
Tinashe - Player (Jai Wolf Remix)
Michael Coveto - Im On You ft. Tory Lanez
Kav Verhouzer - People ft. LarryKoek and ENTRPNR
Hailee Steinfeld - Love Myself (Fareoh Remix)
Marcus Schössow - CNTRL ft. Dave Winnel
Avicii - Pure Grinding (iSHi Remix)
Breathe Carolina & Shanahan - Stars & Moon ft. HALIENE
KOLAJ - Hello
Foxes - Devil Side
Johnny Rain - Dance...
Moon Bounce - Body
Tiësto - Get Down ft. Tony Junior
Axwell Λ Ingrosso - Dream Bigger (Instrumental)
RKCB - Daydreaming (Virtu Remix)
Eryn Allen Kane - Piano Song
Louis Mattrs - WGW ft. Lucki Eck$
DJ Snake - Propaganda
Woodlock - Sirens
KALK - Hold Tight
VHS Collection - Lean
Taylor Bennett - You ft. Jordan Bratton
Russ - Down for You
Chet Porter - Awakening
Roo Panes - The Original
Evawolf - When The Truth Is Out
Shlohmo - Ten Days Of Falling (Baauer Remix)
Martin Garrix - Bouncybob ft. Justin Mylo and Mesto
Little White Things - Step Back
Audrey Air - Strawberry Syrup Sixteens
Luxley - Camera Lens
Seramic - People Say
Cross Record - High Rise