2 ContributorsNew Music Friday 12/09/16 LyricsSteve Aoki - Just Hold On feat. Louis Tomlinson
Major Lazer & Bad Royale - My Number feat. Toots
Whethan - Savage feat. Flux Pavilion & MAX
A R I Z O N A - Oceans Away
Matoma & Gia - Heart Won't Forget
Post Malone - Big Lie
Krewella - Team
Marian Hill - Back to Me feat. Lauren Jauregui
M.O - Not In Love feat. Kent Jones
Fetty Wap - Like a Star feat. Nicki Minaj
J. Cole - Deja Vu
DJ Fresh & Diplo - Bang Bang feat. R. City, Selah Sue & Craig David
Ryan Adams - Do You Still Love Me?
At The Drive-In - Governed by Contagions
G-Eazy - Vengeance On My Mind
Flor - Still Standing Still feat. Lostboycrow
DJ Snake - Let Me Love You feat. Justin Bieber (Don Diablo Remix)
​mansionz - Stfu feat. Spark Master Tap
Bonobo - Break Apart feat. Rhye
Niall Horan - This Town (GOLDHOUSE Remix)
Rationale - Vessels
Tinashe - Company (MUNA Remix)
SHAED - Starboy (Recorded at Spotify Studios NYC)
K.I.D - Taker
The Orwells - Double Feature
Moby & The Void Pacific Choir - Are You Lost in the World Like Me?
Emmit Fenn - Blinded
Ojivolta - Satisfaction feat. Nylo
The-Dream - Lemon Lean
Coucheron - Loud
Taylor Girlz - Wedgie feat. Trinity Taylor
Borgore - Magic Trick feat. Juicy J
Tech N9ne - Sriracha feat. Logic & Joyner Lucas
Jacob Banks - Monster 2.0 feat. Boogie
Ryan Hurd - Hold You Back
Us the Duo - One Last Dance
Mosa Wild - Smoke
Saintseneca - On Holiday
Best Night Ever - Caught Up
Eric Nam & Timbaland - BODY
Fanny Andersen - KIDS
Emeli Sandé - Breathing Underwater (Matrix & Futurebound Remix)
Tory Lanez - LUV (Snakehips Remix)
Pharrell Williams - Crave
Lloyd - Holding feat. Lil Wayne
Star Cast - I Bring Me
Allan Rayman - Faust Road feat. Adria Kain
Jocelyn Alice - Feels Right (Galloway Remix)
Clean Bandit - Rockabye feat. Sean Paul & Anne-Marie (End of the World Remix)
R3hab & Sketch - Everything
Quinn XCII - Straightjacket
Jax Jones - You Don't Know Me feat. RayeEmbed