Cheat Codes - Sex feat. Kris Kross Amsterdam
The Lumineers - Ophelia
Tigertown - Lonely Cities
Adele - When We Were Young
Foxes - All I Need
The Fooo Conspiracy - My Girl
Drake - Summer Sixteen
Yo Gotti - General feat. Future
Majid Jordan - Something About You
Zendaya - Something New feat. Chris Brown
KLOE - Teenage Craze
Jay Sean - Make My Love Go feat. Sean Paul
Lucky Rose - The Way You Want Me feat. Yan Etchevary
Allie X - Old Habits Die Hard
Nothing but Thieves - If I Get High
Deftones - Prayers/Triangles
Young Thug - F Cancer (Boosie) feat. Quavo
Wiz Khalifa - Elevated
Opia - Falling
The Ready Set - Good Enough
WDL - Hurricane Highlife feat. Mawe
Chris Stylez - What Are We Waiting For
Lucius - Something About You
KAMAU - Jusfayu feat. No Wyld
Autograf - Future Soup feat. Patrick Baker
Gallant - Skipping Stones feat. Jhené Aiko
MØ - New Year's Eve
Leo Standard - My Friends Got Love
Francis - Horses
JAHKOY - Odd Future
Greyson Chance - Hit & Run
Paperwhite - Unstoppable
Satchmode - Don't Give Up on Me
Monogem - Gone (INSTRUM Remix)
Animal Collective - Lying in the Grass
Nada Surf - Cold to See Clear
Radical Face - Secrets (Cellar Door)
Run River North - 29
Photo Ops - I'd Be Dead
Allen Stone - Voodoo
Charles Kelley - Lonely Girl
Dan + Shay - From the Ground Up
Blondfire - True Confessions
Hembree - Can't Run Forever
Moderat - Reminder
Jamie xx - SeeSaw (Club Version) feat. Four Tet & Romy
Kill J - Trickle Trickle