Fletcher - Avalanche
FRENSHIP - Carpet
Broods - We Had Everything
NEIKED - Sexual
Cash Cash - Turn feat. Little Daylight
Imad Royal - Bad 4 U feat. Blaise Railey
Palmistry - Lifted
Ofelia K - I Love My Lawyer
The Hunna - Bonfire
Dorothy - Missile
Blink-182 - No Future
Oliver Nelson - Changes feat. River
Dizzee Rascal & Calvin Harris - Hype
Era Istrefi - Bonbon
Adele - Remedy
Wrabel - 11 Blocks
MAGIC! - Red Dress
Pretty Sister - West Coast
Brandyn Burnette - Underneath (Remix)
Cierra Ramirez - Faded feat. Casey Veggies & Honey C
Logic - Wrist feat. Pusha T
Miguel - The Thrill (Live from Spotify SXSW 2016)
Maxwell - Gods
Airplane Man - We're on Fire
Gucci Mane - All My Children
Steve Aoki - How Else feat. ILoveMakonnen & Rich The Kid
Vicetone - Nevada feat. Cozi ZuehlsdoFrff
Khalid - Let's Go
LANY - like you lots
Yellowcard - Rest In Peace
Broods - Are You Home
Dive In - Rush of the Night
Colony House - You Know It
Butch Walker - Stay Gold
The Tallest Man On Earth - Time of the Blue
Cyndi Lauper - Time After Time
The Avett Brothers - No Hard Feelings
Sigur Rós - Óveður
DREAMERS - Sweet Disaster
Cymbals Eat Guitars - 4th of July, Philadelphia (SANDY)
Demo Taped - Not Enough
DJ Shadow - The Sideshow feat. Ernie Fresh
Dreezy - Close to You feat. T-Pain
LEO ISLO - Blame
Hannah Georgas - Waste
Ferras - Closer
Sälen - Diseasey
KAYE - Honey
Marian Hill - Talk to Me
Venus and the Moon - Marry Me
Shovels & Rope - I Know
Motionless In White - 570
Heavy Hearts - Bliss