2 ContributorsNew Music Friday 08/28/15 LyricsJustin Bieber - What Do You Mean?
The Weeknd - Real Life
Macklemore & Ryan Lewis - Downtown feat. Eric Nally, Melle Mel, Kool Moe Dee and Grandmaster Caz
Avicii - For a Better Day
Halsey - Colors
Little Mix - Hair
Jon Foreman - June & Johnny
Diplo - Be Right There feat. Sleepy Tom
5 Seconds of Summer - Jet Black Heart
OMI - Hula Hoop
TOTEM - Unrequited
Alessia Cara - Seventeen
The Weeknd - Acquainted
RAC - Can't Forget You feat. Chelsea Lankes
Petite Noir - MDR
Foals - Night Swimmers
Saintseneca - Sleeper Hold
On An On - Drifting
Little May - Seven Hours
Jain - Makeba
Charlie Puth - Marvin Gaye feat. Meghan Trainor
FLETCHER - War Paint (Young Bombs Remix)
Jess Glynne - Ain't Got Far to Go
KOPPS - My Gold
Eliot Sumner - Firewood
From Indian Lakes - Late in the Night
Beach House - Space Song
Jasmine Thompson - Do It Now
Boh Doran - Karma
Imagine Dragons - Roots
Bring Me the Horizon - True Friends
FIDLAR - Leave Me Alone
Kwamie Live - Pleasure This Pain feat. Angel Haze
Korallreven - Here In Iowa
ISLAND - Stargazer
CÅ“ur De Pirate - Undone
Atlas Genius - Balladino
Satchmade - Hall & Oates
Tink - Wet Dollars feat. Tazer
K-OS - Crucify
Andra Day - Forever Mine
Andrew Ripp - Falling Faster
Josh Ritter - Where the Night Goes
Northcote - You Could Never Let Me Down
B.Miles - Salt
August Alsina - Why I Do It feat. Lil Wayne
The Weeknd - In the Night
Keys N Krates - I Know U
DJ Spinn - Dubby feat. DJ Rashad & Danny Brown2Embed