The Weekend - I Feel It Coming feat. Daft Punk
Sean Paul - No Lie feat. Dua Lipa
G-Eazy - Some Kind of Drug feat. Marc E. Bassy (Earwulf Remix)
Sia - Never Give Up
Noah Cyrus - Make Me (Cry) feat. Labrinth
Usher - Wait for It
The Weeknd - Party Monster
Bruno Mars - Straight Up & Down
John Mayer - Love on the Weekend
Justice - Fire
John Legend - Penthouse Floor feat. Chance the Rapper
DNCE - Truthfully
Little Mix - Touch
OneRepublic - Kids (Seeb Remix)
Childish Gambino - Redbone
The Chain Gang of 1974 - Slow
The Americanos - In My Foreign feat. Ty Dolla $ign, Lil Yachty, Nicky Jam & French Montana
Blackbear - Flirt Right Back
Jhené Aiko - Maniac
Nas, Dave East, Lin-Manuel Miranda & Aloe Blacc - Wrote My Way Out
Eminem - Infinite
E-40 - Puttin' In Work
Metallica - Murder One
Highly Suspect - For Billy
Eden Prince - P.YT. (Pretty Young Thing)
Trey Songz - Comin Home
Post Malone - Patient
Andrew McMahon in the Wilderness - Brooklyn, You're Killing Me
Santigold - Who I Thought You Were
Jai Wolf - Gravity feat. JMR
Sean Paul - Tek Weh Yuh Heart feat. Tory Lanez
Aaron Camper - Blow
Pharrell Williams - Crave
Niall Horan - This Town (Live, 1 Mic 1 Take) ✅
Bay Ledges - Safe
Miranda Lambert - Pushin' Time
Nathaniel Rateliff & The Night Sweats - I Did It
Grace VanderWaal - I Don't Know My Name
Violet Days - O.D on You
​pronoun - a million other things
Billie Eilish - Ocean Eyes
NVDES - I Want to Make Out at the Gay Club
Run the Jewels - 2100 feat. BOOTS
Lupe Fiasco - Made in the USA feat. Bianca Sings
Morgan Page - Don't Give Up feat. Lissie
Michael Woods - Orchestra feat. Jason Walker
Bridgit Mendler - Snap My Fingers
Electric Guest - Dear to Me
BANNERS - Holy Ground
Vallis Alps - Fading
MUNA - Loudspeaker (Absofacto Remix)
Lost Kings - Phone Down feat. Emily Warren (TELYKast & BKAYE Remix)
The Knocks - HEAT feat. Sam Nelson Harris (Manila Villa Remix)
Jorja Smith - Carry Me Home feat. Maverick SabreEmbed