2 ContributorsNew Music Friday 11/04/16 LyricsSongs with a ✅ contain verified annotations and/or lyrics!

Marshmello - Ritual feat. Wrabel
Aanysa & Snakehips - Burn Break Crash
Cheat Codes - Queen Elizabeth
Sigma - Find Me feat. Birdy
Bruno Mars - Versace on the Floor
The Chainsmokers - Setting Fires feat. XYLØ
Future - Used to This feat. Drake
Salt Cathedral - Unraveling feat. Matisyahu
Nick Murphy - Stop Me
Kim Cesarion - Therapy
Jane Zhang - Dust My Shoulders Off feat. Timbaland
Big Sean - Bounce Back ✅
Tinashe - Sacrifices
Maggie Rogers - Dog Years ✅
Niall Horan - This Town (Tiësto Remix) ✅
OBB - Sweater
Bridgit Mendler - Do You Miss Me at All
Kiiara - dopemang feat. Ashley All Day
Flume - Say It feat. Tove Lo (Anna Lunoe Remix)
The Japanese House - Good side in
Alicia Keys - Where Do We Begin Now
Miranda Lambert - Highway Vagabond
Little Mix - F.U
Stevie Wonder - Faith feat. Ariana Grande
Badflower - White Noise
You Me At Six - Give
Metallica - Atlas, Rise!
Dae Dae & London On Da Track - Bullshit feat. 21 Savage
A$AP Mob - Bachelor feat. A$AP Rocky, Lil Yachty, Madeintyo & Offset
Dave - Wanna Know (Remix) feat. Drake ✅
Post Malone - Congratulations feat. Quavo
Saint Mesa - Roses
Client Liaison - World of Our Love
Day Wave - Wasting Time
STRFKR - Maps
​lil aaron - 4 MORE DRINKS / PINK FENTY SLIDES
Bonobo - Kerala
Common - Unfamiliar feat. PJ
Matthew Koma - Kisses Back
DNCE - Good Day
Grouplove - Welcome to Your Life (TaylorWise Remix)
Broods - Heartlines (Cheat Codes Remix) ✅
So Below - Hard
Ten Fé - Overflow
Tayá - Deeper
Felix Snow - Love feat. Lil Uzi Vert
Japandroids - Near to the Wild Heart of Life
Papa Roach - Crooked Teeth
Sundara Karma - The Night
Mark Johns - Wait Till Tmrw
NVDES - My Mind Is feat. Oliver Tree
Liv Dawson - Open Your Eyes
Neil Young - Peace Trail
High Valley - Memory Makin'1Embed