Robin Schulz & David Guetta - Shed a Light feat. Cheat Codes
Flume - TRUST feat. Isabella Manfredi
Pitbull - Can't Have feat. Steven A. Clark & Ape Drums
DJ Snake - Let Me Love You feat. Justin Bieber (Tiësto's AFTR:HRS Mix)
The Weeknd - Nothing Without You
G-Eazy - Still
Calum Scott - Rhythm Inside
Hot Shade & Mike Perry - Touching You Again feat. Jane XØ
Ashanti - Helpless feat. Ja Rule
The Weeknd - Sidewalks feat. Kendrick Lamar
G-Eazy - Bone Marrow feat. Danny Seth
Breathe Carolina - ECHO (LET GO) feat. IZII
John Legend - I Know Better
DVBBS & CMC$ - Not Going Home feat. Gia Koka
The Weeknd - A Lonely Night
Tommy Sunshine & Halfway House - Not Dead yet feat. Michael Bernard Fitzgerald
Møme - Why Is It feat. Merryn Jeann
Rag'n'Bone Man - Human (Acoustic)
Lizzy Land - Sweet Melodies
3LAU & MAX - You Want More
Rationale - Prodigal Son
Kid Ink - Overdrive feat. P. Wright
The Weeknd - Six Feet Under
DJ Suede The Remix God - You Name It! (#UNameItChallenge)
YG - I Be On feat. 21 Savage
Devon Baldwin - Dead of Night
Slushii - Morphine
You Me At Six - Swear
Black Map - Run Rabbit Run
No Wyld - Tomorrow feat. Allan Kingdom
Otto Knows - Not Alone
TeamMate - We Belong
Kita Alexander - Damage Done
Dylan Gardner - Sign Language
Tim Legend - Hope feat. Brave
Isac Elliot - What About Me (Bit Funk Remix)
Klangkarussell - Hey Maria (Ynnox Remix)
Martin Solveig - Places feat. Ina Wroldsen
Matt Maeson - Cringe
Anne-Marie - Peak (Stripped)
Beyoncé & Dixie Chicks - Daddy Lessons
Gillian Welch - By the Mark
The Rolling Stones - Ride Em On Down
The Skins - Runaway
Jordan Fisher - You're Welcome feat. Lin-Manuel Miranda
Daniel Syke - No Party
Hippo Campus - Monsoon
Bad Rabbits - Flames
Bruno Major - Easily
Ta-ku & Wafia - Love Somebody (Poté Remix)
GoldFish - Deep of the Night feat. Diamond Thug
Sylvan Esso - Kick Jump Twist
Unlike Pluto - Someone New feat. Desi Valentine
Pete Tong - PorcelainEmbed