7 ContributorsNew Music Friday 07/15/16 LyricsLedinsky â€“ DonaldTrumpMakesMeWannaSmokeCrack
5 Seconds of Summer - Girls Talk Boys
Felix Jaehn - Bonfire feat. ALMA
Zeds Dead x Diplo - Blame feat. Elliphant
Snakehips - Cruel feat. ZAYN
Grouplove - Welcome to Your Life
Gucci Mane - Guwop Home feat. Young Thug
Morgxn - love you with the lights on
Terror Jr. - Say So
Jocelyn Alice - Feels Right
HUNGER - Amused
Yellow Claw - Invitation feat. Yade Lauren
Kehlani - CRZY
HONNE - Good Together
Jagwar Ma - O B 1
Banks - Fuck With Myself
EDEN - drugs
Jazz Morley - Take Me Down
A R I Z O N A - I Was Wrong (Robin Schulz Remix)
Kaptan - Numbers
AlunaGeorge - Mean What I Mean feat. Leikeli47 & Dreezy
Wensday - Bones
DJ Snake & Yellow Claw - Ocho Cinco
Young and Divine - Stay Cool
PJ - Can't Stop
Tinashe - Superlove
Ty Dolla $ign - Campaign feat. Future
Steve Aoki & Shaun Frank - Dope Girlz
Nani -  I Am Volcano
Brent Cobb - Solving Problems
NEEDTOBREATHE - HARD LOVE
Lindsey Stirling - Something Wild (From "Pete's Dragon") Feat. Andrew McMahon in the Wilderness
Alicia Keys - In Common (Radio Mix)
Bakermat - Living feat. Alex Clare
Goodbye June - Darlin'
The Head and The Heart - Library Magic
Leisure - Control Myself
Charlotte Cardin - Like It Doesn't Hurt feat. Husser
ZHU - Palm of My Hand
Floria Georgia Line - May We All feat. Tim McGraw
Jeff Beck - Live in the Dark
Descendents - Without Love
888 - Critical Mistakes
Chris Lane - Let Me Love You
Michael Kiwanuka - One More Night
MUNA - Loudspeaker (Live from Spotify House SXSW '16)
Saint PHNX - Reload
G4SHI - Jean Claude Van Damme
Gucci Mane - No Sleep (Intro)
M.I.A. - Go Off
Tish Hyman - Dreams feat. Fabolous & Ty Dolla $ign
Klangstof - We Are Your Receiver1Embed