
The Chainsmokers - Closer feat. Halsey
Andy Grammer - Fresh Eyes
Martin Garrix - In the Name of Love feat. Bebe Rexha
ZHU - Hometown Girl
Party Favor - Give It to Me Twice feat. Sean Kingston & Rich the Kid
Glass Animals - Youth
JoJo - Fuck Apologies. feat. Wiz Khalifa ✅
Mac Miller - Dang! feat. Anderson .Paak
D.R.A.M. - Cute
Stanley - Call On Me
Flo Rida - Zillionaire
Betty Who - I Love You Always Forever (Instant Karma Remix)
Jarryd James - How Do We Make It
Goldroom - Lying to You
Jason Derulo - Kiss the Sky
Dawin - Bikini Body feat. R. City
Sabrina Carpenter - On Purpose
Tory Lanez - Flex
Oscar and the Wolf - The Game
Ofelia K - Killing Me
Shawn Mendes - Three Empty Words
The Mowgli's - Spacin Out ✅
Descendents - Victim of Me
Phantogram - Run Run Blood
Lliam - Someday feat. Latroit
Slushii - So Long feat. Madi
Judah & The Lion - Take It All Back 2.0
Billy Talent - Afraid of Heights
Bastille - Fake It
Two Door Cinema Club - Bad Decisions
A Day To Remember - Bullfight
Steve Aoki & Reid Stefan - Bring the Funk Back
Jack Ü - Mind feat. Kai (Malaa Remix) ✅
Coyote Kisses - Waiting for You feat. Madison Love
How to Dress Well - Lost Youth / Lost You
Ashley Wallbridge - Melody feat. Karra
Fantasia - Sleeping With the One I Love
Fickle Friends - Cry Baby
Jamestown Revival - Love is a Burden
Butch Walker - Ludlow Expectations
The Shires - Beats to Your Rhythm
Grammar - Americana
​morgxn - notorious
Carah Faye - Don't Say a Word
Illy - Papercuts feat. Vera Blue
KINGDM - Superman
MOONZz - Wonder
Britt Nicole - Through Your Eyes
Andra Day - The Only Way Out
Kenny Chesney - Setting the World on Fire feat. P!nk
Lori McKenna - Humble & Kind
The Temper Trap - Fall Together (Kasbo Remix)
CHVRCHES - Clearest Blue (Gryffin Remix) ✅
Sunflower Bean - Easier Said (Jim Eno Sessions)
Porches - Pool (Live from Spotify House SXSW '