4 ContributorsNew Music Friday 10/14/16 LyricsSongs with a ✅ contain verified annotations and/or lyrics!

Kings of Leon - Find Me
Machine Gun Kelly - Bad Things feat. Camila Cabello
Maroon 5 - Don't Wanna Know feat. Kendrick Lamar
SeeB - What Do You Love feat. Jacob Banks
Tove Lo - True Disaster
Alex Vargas - Higher Love
Sons of Maria - Sweet Madness feat. Angelika Vee
Witt Lowry - Numb
Captain Cuts - Love Like We Used To feat. Nateur
Harlœ - All In My Feelings
Hardwell - Thinking About You feat. Jay Sean
Glades - Skylines
Two Door Cinema Club - Lavender
Sergioisdead - U feat. Merges
KREAM - Taped Up Heart feat. Clara Mae
3LAU & Said the Sky - Fire feat. Christina
Many Voices Speak - Blue Moon
Ryan Hurd - City Girl
Jimmy Eat World - You Are Free
Zeds Dead - Symphony feat. Charlotte OC
Jagwar Ma - Ordinary
Lauren Aquilina - Midnight Mouths (filous remix)
The Naked and Famous - Last Forever
Death Cab for Cutie - Million Dollar Loan
Henry Jamison - The Rains
The Chain Gang of 1974 - I Still Wonder (The New Divisions Remix)
Aquilo - You Won't Know Where You Stand
Benny Cassette - Be Wild feat. Alice Leigh
JoJo - Vibe
Chris Miles - weatherman
Sabrina Carpenter - No Words
Macklemore & Ryan Lewis - Drug Dealer feat. Ariana Deboo
Pusha T - Circles feat. Ty Dolla $ign & Desiigner
R3hab - Icarus
Destructo - Winning feat. Problem
Phora - Distance
Gucci Mane - Hi-Five
Sage the Gemini - Now and Later
Emeli Sandé - Garden feat. Jay Electronica & Áine Zion
Sofi de la Torre - Flex Your Way Out feat. Blackbear
Sevyn Streeter - D4L feat. The-Dream
Parson James - Sad Song
Cherub - Signs feat. T.I
Big K.R.I.T. - Free Agent
Shea Diamond - I Am Her
Hippo Campus - Boyish
Saint Motel - Born Again
SAINTE - Technicolor
Coleman Hell - Run Wild
FRANKIE - Blink
Johnnyswim - Let It Matter
Astronomyy - Hypnotized
Golden Coast - Comeback Kid
The Vamps - All Night feat. Matoma ✅
Matt Thomas - Take Me Serious
6LACK - Ex Calling
Sara Hartman - Dance with a Ghost
Avenged Sevenfold - The StageEmbed