
Jonas Blue - By Your Side feat. Raye
Drake - Fake Love
Bebe Rexha - I Got You
Tove Lo - Keep it Simple
The Skins - Bury Me feat. D.R.A.M. ✅
Empire of the Sun - Friends
Charli XCX - After the Afterparty feat. Lil Yachty ✅
Dimitri Vegas & Like Mike, Diplo - Hey Baby feat. Deb's Daughter
​gnash - home feat. johnny yukon
James Arthur - Can I Be Him
Lao Ra - Bang Boom
Monsieur Adi - Bad Habits feat. VERITE
Drake - Sneakin' feat. 21 Savage ✅
Dua Lipa - Room for 2
A Boogie Wit da Hoodie - Timeless
CAZZETTE - Static
The Japanese House - Swim Against the Tide
Mona - Us & Then
Tigertown - What You Do
ALMA - Dye My hair
Maty Noyes - lil' bit wrOng
Alessia Cara - How Far I'll Go
Kaleo - Way Down We Go
BRÅVES - A Toast
AFI - Snow Cats
Colony House - Lonely
JAHKOY - 1000 Times
Craig David & Sigala - Ain't Giving Up
Møme - Playground
Pussy Riot - Make America Great Again
Highly Suspect - Little One
Avenged Sevenfold - Angels
The Shins - Dead Alive
Kungs - You Remain feat. Ritual
Meek Mill - Froze feat. Lil Uzi Vert & Nicki Minaj
Jeezy - Where It At feat. Yo Gotti
KOLAJ - Hitchhike
Ricky Reed - Express Myself
Erin McCarley - G O O D
Miranda Lambert - Keeper of the Flame
Alicia Keys - Holy War
Kim Burrell - I See a Victory feat. Pharrell Williams
Little Mix - You Gotta Not
Ralph - Busy Man
Khalid - Hopeless
Emeli Sandé - Breathing Underwater
Bryson Tiller - Let Me Explain
Migos - Bad and Boujee feat. Lil Uzi Vert
2 Chainz - Doors Open feat. Future
Allan Rayman - 25.22
Gryffin - Whole Heart feat. Bipolar Sunshine (Mansionair Remix)
On June - Sunrise feat. Kevi
KDL - With You feat. Fetty Wap
Excision - With You feat. Made
King Arthur - All We Need feat. Undertown
DNCE - Blown feat. Kent Jones
Thomas Rhett - American Spirit
SRNO - Stay Sane feat. Naaz
Alexx Mack - Whatever I Want
Xavier Dunn - Give In feat. AirlingEmbed