4 ContributorsNew Music Friday 09/30/16 LyricsSongs with a ✅ contain verified annotations and/or lyrics!

The Chainsmokers - All We Know feat. Phoebe Ryan
Niall Horan - This Town ✅
Cashmere Cat - Trust Nobody feat. Selena Gomez & Tory Lanez ✅
DNCE - Body Moves
The Weeknd - False Alarm
Mura Masa - Love$ick feat. A$AP Rocky
Francis and the Lights - May I Have This Dance
Bon Iver - 666 ʇ
Louis the Child - Fire feat. Evalyn
Daya - Cool
The Japanese House - Face Like Thunder
​gnash - something
Maggie Lindemann - Pretty Girl
David Guetta, Chris Willis & Cedric Gervais - Would I Lie to You
Young & Divine - The Garden
Owen Bones - Mach One feat. Tunji Ige & Lil Aaron
Vic Mensa - Go Tell 'Em
LIV - Wings of Love
Train - Play That Song
HERO - The Juice
Solange - Cranes in the Sky
Banks - Trainwreck
Major Lazer & Showtek - Believer
Zeds Dead - Stardust feat. Twin Shadow
Cosmos & Creature - Young
Yellowcard - Got Yours
Saint Mesa - Jungle
Metallica - Moth Into Flame
Anik Khan - Cleopatra
Bibi Bourelly - Ballin
FLETCHER - Princess
Daniel Skye - Good As It Gets
Tigertown - Papernote
Roy English - Worldstop
Terror Jr - Say So (Vasco Remix)
Vice - Steady 1234 feat. Jasmine Thompson & Skizzy Mars
King Deco - Read My Lips
GTA - All Caught Up feat. Tinashe
Rich Gang - Balla Blocka
Juicy J - Ballin feat. Kanye West ✅
OneRepublic - A.I. feat. Peter Gabriel
Thomas Rhett - Star of the Show
Regina Spektor - Grand Hotel
Johnnyswim - Drunks
Charlotte OC - Darkest Hour
SHELLS - Jailbird
Cobi - Prophet Story
Bailey Bryan - Own It
Galantis & Hook N Sling - Love on Me
Hotel Garuda - Fixed on You feat. Violet Days
XYLØ - Dead End Love
​pronoun - a million other things
Phantogram - You're Mine
Jagwar Ma - Slipping
The Lumineers - Boots of Spanish Leather
Moses Sumney - Worth It
Reva DeVita - THE MOVE
Janelle Kroll - Outsider
The Mowgli's - Automatic
Ferras - Medicine feat. Raja Kumari
Kevin "Chocolate Droppa" Hart - Push It on Me feat. Trey Songz
Underworld - Ova Nova
The Avener - You Belong feat. Laura Gibson
Hayley Kiyoko - Palace
Two Door Cinema Club - Gameshow
​illion - Told U SoEmbed