3 ContributorsNew Music Friday 04/15/16 LyricsDrake - One Dance feat. Kyla & WizKid
AlunaGeorge - I Remember feat. Flume
Terror Jr - 3 Strikes
Boyce Avenue - Imperfect Me
KONGOS - Take It From Me
Justin Jay - What Do You Want feat. Josh Taylor & Benny Bridges
Handsome Ghost - Graduate
Lush & Simon, Gazzo - Wasted Love feat. Robbie Rosen
Snakehips - Dímelo feat. Tory Lanez
Drake - Pop Style feat. The Throne
A$AP Ferg - Strive feat. Missy Elliott
Rae Sremmurd - Look Alive
K CAMP - 5 Minutes feat. 2 Chainz
Tom Odell - Magnetized
P!nk - Just Like Fire
James TW - Naked
Bear Hands - Déjà Vu
Lauren Aquilina - Kicks
The Avett Brothers - Ain't No Man
Young the Giant - Amerika
The Temper Trap - Fall Together
Draper - Break Over You feat. Prides
Frenship - Capsize feat. Emily Warren
Don Diablo - Silence feat. Dave Thomas Junior
Brett Dennen - Cassidy
Yoke Lore - Hold Me Down
Layne - Good
The Chainsmokers - Don't Let Me Down feat. Daya (W&W Remix)
LE YOUTH - Boomerang feat. Tay Beckham
Zhu - In the Morning feat. Kaskade
Classixx - Just Let Go feat. How to Dress Well
Jordan Fisher - All About Us
Conrad Sewell - Remind Me (Steve James Remix)
Meghan Trainor - I Love Me feat. Lunchmoney Lewis
Sia - Cheap Thrills feat. Sean Paul (RAC Remix)
Snakehips - Falling feat. Malika
Edward Sharpe & The Magnetic Zeros - No Love Like Yours
Ciaran Lavery - Okkervil River
Phoria - Everything Beta
Naomi Pilgrim - Sink Like a Stone
Charlotte Cardin - Like It Doesn't Hurt feat. Husser
Tritonal - Blackout feat. Steph Jones (Madison Mars Radio Mix)
Conro - City Lights feat. Royal
Sigala - Give Me Your Love feat. John Newman & Nile Rodgers
Sturgill Simpson - In Bloom
Yung - Uncombed Hair
Against the Current - Forget me Now
Andy Black - Ribcage
Demo Taped - Game On
GOLDHOUSE - On & OnEmbed