DJ Snake - Talk feat. George Maple
MUNA - Winterbreak (TiÃ«sto's Deep House Remix)
Alan Walker - Sing Me to Sleep
Fitz and the Tantrums - Roll Up
Joey Bada$$ - Devastated
Jonas Blue - Perfect Strangers feat. JP Cooper
Nick Jonas - Bacon feat. Ty Dolla $ign
Cash Cash & Digital Farm Animals - Millionaire feat. Nelly
Manila Killa - Youth feat. SATICA
CAZZETTE - Blue Sky feat. Laleh
Mumford & Sons - Wona feat. Baaba Mal, The Very Best & Beatenberg
Otto Knows - Back Where I Belong feat. Avicii
Tegan and Sara - Stop Desire
Rihanna - Kiss It Better (R3hab Remix)
Fetty Wap - My Environment
Mac Miller - Best Day Ever
The Strokes - OBLIVIUS
Volbeat - Let It Burn
NEEDTOBREATHE - GREAT NIGHT feat. Shovels & Rope
Weathers - Happy Pills
Betty Who - I Love You Always Forever
Classixx - Safe Inside feat. Passion Pit
Rationale - Palms
EMBRZ - Breathe
Beck - Wow
Handsome Ghost - Eyes Wide feat. Whole Doubts
Will Joseph Cook - Take Me Dancing
Maren Morris - 80s Mercedes
Adam Friedman - Lemonade feat. Mike Posner
BANNERS - Half Light
The Head and the Heart - All We Ever Knew
Lost Frequencies - Beautiful Life feat. Sandro Cavazza
GoldLink - Unique feat. Anderson .Paak & Tyler Minford (Louis Futon Remix)
Ladyhawke - A Love Song
Jon Bellion - Maybe IDK
Phoria - Everything Beta
The Kills - Doing It to Death
Bryce Fox - Voodoo
Molly Moore - Blood. Sweat. Tears. (John Lock Remix)
Elle King - Good Girls
Bear Mountain - Give It Up
Slaptop - Think About You
A Tribe Called Red - Stadium Pow Wow feat. Black Bear
The Hotelier - Goodness, Pt. 2
Ro James - GA$
Dan + Shay - Obsessed
Maxwell - 1990x
The Avalanches - Frankie Sinatra feat. Danny Brown & MF DOOM
Train - What Is and What Should Never Be
Lukas Graham - Mama Said (Spotify Sessions)