3 ContributorsNew Music Friday 10/21/16 LyricsSongs with a ✅ contain verified annotations and/or lyrics!
Mike Perry - Inside the Lines feat. Casso
Alex Da Kid - Not Easy feat. X Ambassadors, Elle King & Wiz Khalifa ✅
Little Mix - Shout Out to My Ex ✅
Sia - Move Your Body (Alan Walker Remix) feat. Mood Melodies
Lady Gaga - A-YO
James Arthur - Remember Who I Was
Terror Jr - Super Powers
Alesso - Take My Breath Away
Wet - The Middle
Icona Pop - Brightside
Saint Motel - Happy Accidents
Jimmy Eat World - Through
Nightly - Talk to Me
LÉON  - Think About You
Kungs - I Feel So Bad feat. Ephemerals
Little Monarch - No Matter What
The Wind and The Wave - My Mind is an Endless sea
Michael Bublé - Someday feat. Meghan Trainor
Clean Bandit - Rockabye feat. Sean Paul & Anne-Marie
Felix Snow - Lies feat. SZA (Palmistry Remix)
Peking Duk - Stranger feat. Elliphant
D.R.A.M. - WiFi feat. Erykah Badu
Joey Bada$$ - Front & Center
Tkay Maidza - Simulation
Whethan - When I’m Down feat. Oliver Tree
Stef Lang - Stronger
Night Riots - All for You
Spencer Ludwig - Good Time People
Zella Day - Man on the Moon
Little Big Town - Better Man
Denny White - Psycho
Becky Hill - Warm
Ari Lennox - Cold Outside
Joe - Happy Hour feat. Gucci Mane
Rihanna - Love on the Brain (Gigamesh Remix) ✅
Martin Garrix & Jay Hardway - Spotless
The Knocks - HEAT feat. Sam Nelson Harris
Flume - Say It feat. Tove Lo (Clean Bandit Remix)
Korn - Take Me
The Pretty Reckless - Who You Selling For
Mainland - Permission Slip
The Federal Empire - The American Dream
The Flaming Lips - The Castle
NVDES - 8Am
Empire of the Sun - Way to Go
Colouring - Everything Has Grown
Joe Budden - Flex feat. Tory Lanez & Fabolous
Eearz - Gone Be Something
Action Bronson - Durag vs. Headband feat. Big Body Bes
Common - Home feat. Bilal
Jay Prince - Father, Father
Fairchild - Relevance
Otis English - Trigger
Jai Wolf - Like it’s Over feat. MNDR
EL VY - Are These My Jets
Her's - Marcel
Susto - Waves
Pentatonix - Hallelujah
Olivia O’Brien - Find What You’re Looking For
Chris Miles - moment
Dua Lipa - Blow Your Mind (Mwah) [Acoustic]
Mike Taylor - Colours
Justice - Alakazam !
Lostboycrow - Stay a Little Longer
Sweater Beats - Did You Wrong feat. Max
Agnes Obel - It’s Happening AgainEmbed