Clean Bandit - Tears feat. Louis Johnson
Flume - Say It feat. Tove Lo
Jon Bellion - 80's Films
Joseph - White Flag
Tritonal - Getaway feat. Angel Taylor
Axwell^Ingrosso - Thinking About You feat. Karin Park & Richard Archer
Cleopold - Down In Flames
Patrick Baker - Call Me Up
Deadmau5 - Snowcone
Little Big Town - One of Those Days
Bishop Briggs - The Way I Do
Thrice - Death From Above
Red Hot Chili Peppers - The Getaway
Rockie Fresh - Call Me When It's Over feat. Chris Brown
Lil Uzi Vert - Ps & Qs
Cash Cash - How to Love feat. Sofia Reyes (i_o remix)
Fifth Harmony - That's My Girl
Chance the Rapper - No Problem feat. Lil Wayne & 2 Chainz
L.A WOMEN - Hurricane Love
Wiz Khalifa - Pull Up feat. Lil Uzi Vert
HOLYCHILD - Rotten Teeth feat. Kate Nash
Hannah Georgas - Rideback
Flume - Tiny Cities feat. Beck
Wild Beasts - Get My Bang
Martin Garrix & Third Party - Lions In the Wild
Pegboard Nerds & NGHTMRE - Superstar feat. Krewella
WILDES - Illuminate
The Monkees - Me & Magdalena
Band of Horses - Solemn Oath
Garbage - Even Though Our Love is Doomed
Fat Joe - All the Way Up (Remix) feat. French Montana, InfaRed & Jay Z
YG - Why You Always Hatin? feat. Drake & Kamaiyah
Eric Bellinger - Lay Up
Ta-ku - Meet in the Middle feat. Wafia
BÃ˜RNS - It's You
Real Friends - Mess
The Interrupters - By My Side
Big Thief - Paul
Lincoln Jesser - Time Will Tell feat. Samuel Jacob
The Shelters - Nothin' in the World Can Stop Me Worryin' 'Bout That Girl
Train - Ramble On
Tom Misch - Watch Me Dance
Blake Shelton - Came Here to Forget
Albin Lee Meldau - Let Me Go
Ciaran Lavery - Return to Form
Kina Grannis - California
The Knocks - Love Me Like That feat. Carly Rae Jepsen (The Knocks 55.5 VIP Mix)
Martin Solveig - Do It Right feat. Tkay Maidza
Charles Bradley - The World (Is Going Up in Flames) [Live from SXSW 2016]
Miike Snow - Genghis Khan (Jim Eno Sessions)
Kaleo - Way Down We GoEmbed