Gucci Mane - Pussy Print feat. Kanye West
Pitbull - Greenlight feat. Flo Rida & Lunchmoney Lewis
Eighty Ninety - Heartbreaker
Pierce Fulton - Borrowed Lives feat. NVDES
Enrique Iglesias - Duele el Coraz√≥n (English Version) feat. Tinashe & Javada
Eva Shaw - Rise And Shine feat. Poo Bear
Miranda Lambert - Vice
HONNE - Til The Evening
Prophets of Rage - Prophets of Rage
Solidisco - Summer Heat
French Montana - No Shopping feat. Drake
Era Istrefi - Bonbon (Post Malone Remix)
Ty Dolla $ign - No Justice feat. Big TC
DENM - Lit
Kehlani - Distraction
Ayokay - Kings of Summer feat. Quinn XCII
PARTYNEXTDOOR - Not Nice
Lewis Del Mar - Painting (Masterpiece)
Viceroy - Fade Out feat. Gavin Turek
Desiigner - Tiimmy Turner
Regina Spektor - Bleeding Heart
Korn - Rotting In Vain
Angelica Garcia - Orange Flower
Neck Deep - December (again) feat. Mark Hoppus
Lil Durk - Hated On Me feat. Future
Will Joseph Cook - Take Me Dancing (Joel Wolf Alice Remix)
Cher Lloyd - Activated
Super Duper - Angela
Stalgia - In The Trees
Lupe Fiasco - Pick Up The Phone
THEY. - Deep End
MOD SUN - We Do This Shit feat. DeJ Loaf
Dae Dae - Wat U Mean (Remix) feat. Lil Yachty
Tidus - See You There
O.A.R. - I Go Through
Bear's Den - Red Earth & Pouring Rain
Bibi Bourelly - Perfect. feat Earl St. Clair
Duckwrth - Get Uugly feat. Georgia Anne Muldrow
Trent Dabbs - Don't Believe In Stars
Rayland Baxter - Mr. Rodriguez (Live from Spotify House SXSW '16)
Bad Feelings - Do You Wanna Get High
MSTRKRFT - Runaway
Tasha The Amazon - Prayer
Trevor Guthrie - Wanted
Arkells - Drake's Dad
BLAJK - Lethal
Skratch Bastid - Limoncello feat. Shad
JPNSGRLS - Oh My God
Sultan + Shepard - Love Me Crazy feat. Gia