6 ContributorsNew Music Friday 04/29/16 LyricsFlorida Georgia Line - H.O.L.Y
Calvin Harris - This Is What You Came For feat. Rihanna
Blink-182 - Bored to Death
Mike Posner - Buried in Detroit feat. Big Sean (Lucas Lowe Remix)
Zedd & Kesha - True Colors
R3hab & Felix Snow - Care feat. Madi
Coleman Hell - Fireproof
Ingrid Michaelson - Hell No
Imagine Dragons - Not Today
Margaret - Cool Me Down
Young the Giant - Something to Believe In
Elohim - Sensations
Kent Jones - Don't Mind
AlunaGeorge & ZHU - My Blood
Meghan Trainor - Mom feat. Kelli Trainor
B.o.B - Roll Up feat. Marko Penn
Alan Walker - Faded (Tiësto's Deep House Remix)
Youngr - Out of My System
Tom Odell - Constellations
Pierce the Veil - Circles
Thrice - Black Honey
Krewella & Diskord - Beggars
George Maple - Sticks and Horses feat. GoldLink
Mali Music - Digital
Violet Days - Your Girl
PANTyRAiD - Six A.M. feat. Bobby Saint
DJ Shadow - Nobody Speak feat. Run the Jewels
Cash Cash - How to Love feat. Sofia Reyes
Brandyn Burnette - Underneath feat. Win and Woo
Band of Horses - Casual Party
Volbeat - The Bliss
Bishop Briggs - River
Conner Youngblood - A Summer Song
Axwell^Ingrosso - Dream Bigger feat. Pharrell
Kyla La Grange - Hummingbird
Chuck Inglish & Blended Babies - Over Much feat. Alex Wiley & Caleb James
Kaleo - Vor í Vaglaskógi
Martina McBride - Everybody Wants to be Loved
Dan + Shay - Already Ready
Ryan Kinder - Sorry
Matt and Kim - Let's Run Away
Max Frost - President
Klangstof - Amansworld
Chloe x Halle - Red Lights
Mike Taylor - Body High
Jenaux - Get It On
KONGOS - I Don't Mind
Rebecca Clements - Bad TV
Unknown Mortal Orchestra - Shakedown Street
Amy Grant - Baby Baby feat. Tori Kelly
Bloodboy - Human Female1Embed