1 ContributorTop Artists of 2021 LyricsBad Bunny - Yonaguni
Taylor Swift - Red (Taylor's Version)
BTS - Butter
Drake - Way 2 Sexy (with Future & Young Thug)
Justin Bieber - Ghost
The Weeknd - Take My Breath
J Balvin & Maria Becerra - Qué Más Pues?
Ariana Grande - positions
Olivia Rodrigo - drivers license
Juice WRLD - Already Dead
Dua Lipa - Levitating
Rauw Alejandro - Todo De Ti
Ed Sheeran - Shivers
Doja Cat - Woman
Billie Eilish - Happer Than Ever (Edit)
Kanye West - Praise God
Eminem - Godzilla (feat. Juice WRLD)
Myke Towers - ALMAS GEMELAS
Travis Scott - ESCAPE PLAN
Pop Smoke - What You Know Bout Love
Post Malone - One Right Now (with The Weeknd)
The Kid LAROI - WITHOUT YOU
XXXTENTACION - Jocelyn Flores
Bruno Mars, Anderson .Paak & Silk Sonic - Leave The Door Open
Ozuna - Caramelo
Lil Nas X - MONTERO (Call Me By Your Name)
David Guetta, MistaJam & John Newman - If You Really Love Me (How Will I Know)
Polo G - Bad Man (Smooth Criminal)
Coldplay - Higher Power
DaBaby - Red Light Green Light
Maroon 5 - Lost
Anuell AA - Reggaetonera
Maluma - Sobrio
Khalid - Present
Rihanna & Drake - Work
Imagine Dragons - Wrecked
Jhay Cortez & Anuel AA - Ley Seca
Lil Baby - Woah
Daddy Yankee - PROBLEMA
J. Cole - a m a r i
Farruko - Pepas
One Direction - What Makes You Beatiful
Queen - Don't Stop Me Now (Remastered 2011)
Sech - Sal y Perrea
Lady Gaga - Rain On Me (with Ariana Grande)
Harry Styles - Watermelon Sugar
Shawn Mendes & Tainy - Summer of Love
KAROL G - BICHOTA
Adele - Easy On Me
Future - Mask OffEmbed